Checking objects for missing descriptions...

- cabinet has no description
- dongle has no description
- crowbar has no description
- office drawer has no description
- office key (Well, it's no dongle, but maybe this key will help?) has no description

Checking rooms for missing descriptions...

(Welcome to the tutorial! Hints will appear in parentheses like this. Commands will be in ALL CAPS. You can enter commands by typing them in and pressing the enter/return key. Leave the tutorial at any time with the GAME command.
)
Well, now you've done it. It's late Friday night, and the building is all locked up. You left the flash drive with your prototype in the office. You need it for your presentation tomorrow!

Tutorial
An Interactive Fiction by Joshua McLean
Release 1 / Serial number 201018 / Inform 7 build 6M62 (I6/v6.33 lib 6/12N) SD

Parking Lot
You're in a large parking lot behind the office building, with grass surrounding the empty blacktop island in all directions. To the north, a large tree blocks any clear view of your office window.

(You can move in any cardinal direction: NORTH SOUTH EAST WEST NORTHEAST NORTHWEST SOUTHEAST SOUTHWEST. You may also abbreviate these commands as N S E W NE NW SE SW. Try moving toward the tree.)

>n. u. get apple. i. open window. d. drop apple. d. hi man. ask about name. x man. ask for apple. drop apple. ask for crowbar. ponder. tell him about window. u. open window with crowbar. n. x desk. open desk. get key. open cabinet. get dongle. s. d. d. s
Bottom of the Tree
A tree rises high into the sky here. Even craning your neck, you can't see the top. The trunk almost presses against the building and it looks like a branch could get you inside through the window.

(Look, a person! Try saying hello. You can TALK TO MAN or SAY HELLO TO MAN or even simply HELLO MAN.)

Tree Branch
You dangle from a high branch, surrounded by green leaves. The branch extends close enough to the building to reach a window.

A single apple dangles just within arm's reach. (You can collect items during your adventure. Try GET APPLE now. You can also TAKE APPLE.)

Taken.

(Now that you have the apple, try INVENTORY or I for short to view your inventory.)

You are carrying:
  an apple

(Now, try to OPEN WINDOW to get into the office.)

(first unlocking the office window)
The window is locked from the inside. You'll have to find another way to open it.

(Well, can't go that way. Let's try going back DOWN to see if there's anything new in the open field.)

You can't get a good grip while carrying the apple, and it's too big for your pockets.

(This is a pretty narrow branch, so if you DROP APPLE it will probably tumble down to the ground. In a text adventure, there is often "real world" modeling of this kind - what you expect to happen will usually happen if the game allows it.)

You drop the apple to the grass below.

(Go DOWN to return to the ground.)

Bottom of the Tree
A tree rises high into the sky here. Even craning your neck, you can't see the top. The trunk almost presses against the building and it looks like a branch could get you inside through the window.

An old gentleman with tousled gray hair stands here.

(Look, a person! Try saying hello. You can TALK TO MAN or SAY HELLO TO MAN or even simply HELLO MAN.)

"Good evening." The man mimes a tip of the hat, despite not wearing one.

(You are now in a conversation with the man. Try to ASK ABOUT something. Maybe his name?)

"My name is John. Nice to meet you." You shake hands and introduce yourself.

(Good work! Now you know who the man is. Try examining him to find out more.)

An old gentleman.

(He took the apple! Well, that's okay. You didn't need it anyway. But that crowbar might be helpful for getting the window open. Maybe ask him for it?)

"Fell out of that tree right before you. If you really want it, you can have it." He smiles and hands you the apple.

Dropped.

* * *

>n
Bottom of the Tree
A tree rises high into the sky here. Even craning your neck, you can't see the top. The trunk almost presses against the building and it looks like a branch could get you inside through the window.

(Look, a person! Try saying hello. You can TALK TO MAN or SAY HELLO TO MAN or even simply HELLO MAN.)

>u
Tree Branch
You dangle from a high branch, surrounded by green leaves. The branch extends close enough to the building to reach a window.

A single apple dangles just within arm's reach. (You can collect items during your adventure. Try GET APPLE now. You can also TAKE APPLE.)

>get apple
Taken.

(Now that you have the apple, try INVENTORY or I for short to view your inventory.)

>i
You are carrying:
  an apple

(Now, try to OPEN WINDOW to get into the office.)

>open window
(first unlocking the office window)
The window is locked from the inside. You'll have to find another way to open it.

(Well, can't go that way. Let's try going back DOWN to see if there's anything new in the open field.)

>d
You can't get a good grip while carrying the apple, and it's too big for your pockets.

(This is a pretty narrow branch, so if you DROP APPLE it will probably tumble down to the ground. In a text adventure, there is often "real world" modeling of this kind - what you expect to happen will usually happen if the game allows it.)

>drop apple
You drop the apple to the grass below.

(Go DOWN to return to the ground.)

>d
Bottom of the Tree
A tree rises high into the sky here. Even craning your neck, you can't see the top. The trunk almost presses against the building and it looks like a branch could get you inside through the window.

An old gentleman with tousled gray hair stands here.

(Look, a person! Try saying hello. You can TALK TO MAN or SAY HELLO TO MAN or even simply HELLO MAN.)

>hi man
"Good evening." The man mimes a tip of the hat, despite not wearing one.

(You are now in a conversation with the man. Try to ASK ABOUT something. Maybe his name?)

>ask about name
"My name is John. Nice to meet you." You shake hands and introduce yourself.

(Good work! Now you know who the man is. Try examining him to find out more.)

>x man
An old gentleman.

(He took the apple! Well, that's okay. You didn't need it anyway. But that crowbar might be helpful for getting the window open. Maybe ask him for it?)

>ask for apple
"Fell out of that tree right before you. If you really want it, you can have it." He smiles and hands you the apple.

>drop apple
Dropped.

>ask for crowbar
He looks genuinely concerned. "What do you need that for?"

(He's not being very cooperative. What to do next? Try to PONDER and maybe your in-game character will have an idea.)

>ponder
Maybe John will understand the situation if you tell him about the office window. (You can TELL a person ABOUT a topic or thing to inform characters about the world or ASK a person ABOUT a topic or thing to find out what they know.)

>tell him about window
"Oh, well in that case, here you go." He hands you the crowbar.

(Excellent! Since getting the crowbar was an important task, notice your score has gone up by a point. You should SAVE so you don't lose your progress. Notice that the gmae will also inform you when your score increases, as seen below.)

[Your score has just gone up by one point.]

>u
Tree Branch
You dangle from a high branch, surrounded by green leaves. The branch extends close enough to the building to reach a window.

>open window with crowbar
You pry the crowbar into the side of the window and push, breaking it open. That'll be difficult to explain when you come back.

(Excellent! Now you can get into the office to the north.)

>n
Office
Your office is tidy and organized, as you like it, with a desk against the east wall. A tall cabinet stands opposite it. The door to the north leads into the main hall, and a window to the south is open to the outside.

(Take a moment to look around the office. Where did you leave that dongle?)

>x desk
A boring wooden desk with a single closed drawer

(You can sometimes open an object to see what's inside. Try OPEN DESK.)

>open desk
You open the office drawer, revealing an office key (Well, it's no dongle, but maybe this key will help?).

>get key
(You now have the key to the cabinet. You can UNLOCK CABINET WITH KEY, then OPEN CABINET. Or you can simply OPEN CABINET and the game will automatically unlock it, since you have the matching key.)

Taken.

>open cabinet
(first unlocking the cabinet)
(with the office key)
You open the cabinet, revealing a dongle.

>get dongle
You grab the dongle. Your presentation is saved! Now to get back to the car...

Taken.

[Your score has just gone up by two points.]

>s
You brace yourself against the window and leap back to the tree branch. Somehow, it doesn't break beneath your weight.

Tree Branch
You dangle from a high branch, surrounded by green leaves. The branch extends close enough to the building to reach a window.

>d
Bottom of the Tree
A tree rises high into the sky here. Even craning your neck, you can't see the top. The trunk almost presses against the building and it looks like a branch could get you inside through the window.

John stands here.

>s
You jump into your car and speed away, ready for a world-changing presentation - though you aren't looking forward to explaining the window incident on Monday morning.

(Tutorial complete! You scored 3 points.)
(Keep in mind there are many more commands you can use. Just try anything with the form ACTION OBJECT and see what happens.)

    *** The End ***

In that game you scored 3 out of a possible 0, in 27 turns.

Would you like to RESTART, RESTORE a saved game, QUIT, or UNDO the last command?

>hints
Please give one of the answers above.

Would you like to RESTART, RESTORE a saved game, QUIT, or UNDO the last command?

>restart
Checking objects for missing descriptions...

- cabinet has no description
- dongle has no description
- crowbar has no description
- office drawer has no description
- office key (Well, it's no dongle, but maybe this key will help?) has no description

Checking rooms for missing descriptions...

(Welcome to the tutorial! Hints will appear in parentheses like this. Commands will be in ALL CAPS. You can enter commands by typing them in and pressing the enter/return key. Leave the tutorial at any time with the GAME command.
)
Well, now you've done it. It's late Friday night, and the building is all locked up. You left the flash drive with your prototype in the office. You need it for your presentation tomorrow!

Tutorial
An Interactive Fiction by Joshua McLean
Release 1 / Serial number 201018 / Inform 7 build 6M62 (I6/v6.33 lib 6/12N) SD

Parking Lot
You're in a large parking lot behind the office building, with grass surrounding the empty blacktop island in all directions. To the north, a large tree blocks any clear view of your office window.

(You can move in any cardinal direction: NORTH SOUTH EAST WEST NORTHEAST NORTHWEST SOUTHEAST SOUTHWEST. You may also abbreviate these commands as N S E W NE NW SE SW. Try moving toward the tree.)

>hints
I didn't understand that sentence.

* * *

>hints off
Hints are now disabled. You cannot re-enable them later! If you want to turn back, UNDO now.

>l
Parking Lot
You're in a large parking lot behind the office building, with grass surrounding the empty blacktop island in all directions. To the north, a large tree blocks any clear view of your office window.

>n
Bottom of the Tree
A tree rises high into the sky here. Even craning your neck, you can't see the top. The trunk almost presses against the building and it looks like a branch could get you inside through the window.